######
##A  #
#### #
#    #
# ## #
#  B #
######