##########################
##   ###   ##   #        #
####          #   #  ##  #
#A   #####    #   ##  ## #
# ## ## ## #    # # #   ##
#    ##         #    #B  #
##########################